[X]
hailey-royle
2
--------------------------------
--------------------------------
--------------------------------
--------ooooo----ooooo----------
--------o------------o----------
--------o-o--------o-o----------
--------o--o------o--o----------
--------o---o----o---o----------
--------o----offo----o----------
--------o-----oo-----o----------
--------o----o--o----o----------
--------o---o----o---o----------
--------o--o------o--o----------
--------o-o--------o-o----------
--------o----g--a----o----------
--------ooooo----ooooo----------
--------------------------------
--------------------------------
