bubbles
hailey-royle
3
14400540
14400180
00000000001000000000000000000000
00000000010100000000000000000000
00000100001000000110000000000000
00001010000000001001000000010000
00010001000000001001000000101000
00001010000000000110000000010000
00000100000110000000000000000000
00000000000110000000000000011000
00100000000000000000000000100100
01010000000000000000000000100100
00100000000000000000100000011000
00000000110000000001010000000000
00000001001000000000100000000000
00000001001000000000000000000000
00000002110000000000000001100000
00110000000000011000000010010000
00110000000000011000000010010000
00000000000000000000000001100000
