bubbles
hailey-royle
1
---------oo---------------------
--------o--o--------------------
--------o--o----------o-------oo
--oo-----oo--------a-o-o------oo
--oo------------------o---------
-------ooo----------------------
------o---o-----------g---------
------o---o---------o-----------
--o---o---o--------o-o----------
-o-o---ooo----------o-------ooo-
--o------------oo----------o---o
---------------oo----------o---o
-------oo------------------o---o
------o--o------------oo----ooo-
------o--o-----------o--o-------
oo--f--oo------o-----o--o-------
oo------------o-o-----oo--------
---------------o----------------
