plus
hailey-royle
2
---------------oo---------------
-g-------------oo---------------
---------------oo---------------
---------------oo---------------
----a----------oo---------------
---------------oo---------------
---------------oo---------------
---------------oo---------------
oooooooooooooooooooooooooooooooo
oooooooooooooooooooooooooooooooo
---------------oof--------------
---------------oo---------------
---------------oo---------------
---------------oo---------------
---------------oo---------------
---------------oo---------------
---------------oo---------------
---------------oo---------------
