snake
hailey-royle
1
00640271
00640800
00000000000000000000000000000000
00000000000000000000000000000000
00000000000000000000000000000000
00000000000000000000000000000000
00000000000000000000000000000000
00000000000000000000000000000000
00000000000011111100111111000000
00000000000011111100111111000000
00000011110011001100110011112200
00000011110011001100110011112200
00000000111111001111110000000000
00000000111111001111110000000000
00000000000000000000000000000000
00000000000000000000000000000000
00000000000000000000000000000000
00000000000000000000000000000000
00000000000000000000000000000000
00000000000000000000000000000000
