spiral
hailey-royle
4
01200060
00600120
00000000000000000000000000000000
00000000000000000000000000000000
00000000000000000000000000000000
00011111111111111111111111111000
00000000000000000000000000001000
00011111111111111111111111101000
00010000000000000000000000101000
00010111111111111111111110101000
00010100000000000000000010101000
00010101200000000000000010101000
00010101111111111111111110101000
00010100000000000000000000101000
00010111111111111111111111101000
00010000000000000000000000001000
00011111111111111111111111111000
00000000000000000000000000000000
00000000000000000000000000000000
00000000000000000000000000000000
