xx
hailey-royle
3
o--------a----o--o-------------o
-o-------------oo-------------o-
--o----g-------oo------------o--
---o----------o--o----------o---
----o--------o----o--------o----
-----o------o------o------o-----
------o----o--------o----o------
-------o--o----------o--o-------
--------oo------------oo--------
--------oo------------oo--------
-------o--o----------o--o-------
------o----o--------o----o------
-----o------o------o------o-----
----o--------o----o--------o----
---o----------o--o----------o---
--o------------oo-----ff-----o--
-o-------------oo-----ff------o-
o-------------o--o-------------o
